1111111111111
1P010000000C1
1000010R000R1
100011E000001
1111111111111