1111111111111111111111
1P01000R000C0000000R01
1000C100100R0000000001
10R011E0000001C0R00001
1000111000R0C011100011
1111111111111111111111