1111111111111111111111
1P0000010000R010R00001
100C00011R000001000001
100011R111000000000001
10001100000111000C0001
1000110000C11000000001
1000000011111000R00001
1000C00001110001110001
1000000R01110000000001
1000000011110R0C000001
10R0000000110000000E01
100000C000011C00000001
1111111111111111111111
