1111111111111
10000000C0001
10C0011111001
10010000C0001
10010C0P00001
1100000000111
1C001E00000C1
1111111111111